WWWWWWWWWWWWWWWW
W         B    W
W @    SSSSS   W
WGGGGGGGWWWW   W
W    B  B  B   W
W   SSSSSSSSSSSW
W B WWWWWWWWWWWW
W    B  B      W
WSSSSSSSSSS    W
WWWWWWWWWWW B  W
W  X     B     W
W       SSSSSSSW
GGGGGGGGGGGGGGGG